* * * h2 * * * *
h2 h3 h3 h3 * * * *
h1 h3 h2 * * * * *
h1 h2 h1 h2 h1 h3 * *
* * h3 h1 h1 h3 * *
* * h2 h3 h2 h1 * *
* * * * * * * *
* * * * * * * *
27300
0
