h2 * * * * * * *
h1 * * * * * * *
h3 * * * * * * *
h1 * * * * * * *
h2 * * * * * * *
h3 * * * * * * *
* * * * * * * *
* * * * * * * *
5000
0
